"filename", "language", "JavaScript", "JSON", "comment", "blank", "total"
"d:\毕业设计\项目\后端项目\onlinestudy\package-lock.json", "JSON", 0, 2332, 0, 1, 2333
"d:\毕业设计\项目\后端项目\onlinestudy\package.json", "JSON", 0, 28, 0, 1, 29
"d:\毕业设计\项目\后端项目\onlinestudy\src\app\config.js", "JavaScript", 17, 0, 0, 2, 19
"d:\毕业设计\项目\后端项目\onlinestudy\src\app\database.js", "JavaScript", 19, 0, 1, 4, 24
"d:\毕业设计\项目\后端项目\onlinestudy\src\app\error-handler.js", "JavaScript", 77, 0, 0, 3, 80
"d:\毕业设计\项目\后端项目\onlinestudy\src\app\index.js", "JavaScript", 17, 0, 1, 6, 24
"d:\毕业设计\项目\后端项目\onlinestudy\src\constants\error-types.js", "JavaScript", 20, 0, 9, 0, 29
"d:\毕业设计\项目\后端项目\onlinestudy\src\constants\file-path.js", "JavaScript", 10, 0, 0, 2, 12
"d:\毕业设计\项目\后端项目\onlinestudy\src\controller\auth.controller.js", "JavaScript", 26, 0, 0, 3, 29
"d:\毕业设计\项目\后端项目\onlinestudy\src\controller\course.controller.js", "JavaScript", 52, 0, 8, 9, 69
"d:\毕业设计\项目\后端项目\onlinestudy\src\controller\file.controller.js", "JavaScript", 55, 0, 6, 6, 67
"d:\毕业设计\项目\后端项目\onlinestudy\src\controller\user.controller.js", "JavaScript", 17, 0, 4, 1, 22
"d:\毕业设计\项目\后端项目\onlinestudy\src\main.js", "JavaScript", 5, 0, 0, 2, 7
"d:\毕业设计\项目\后端项目\onlinestudy\src\middleware\auth.middleware.js", "JavaScript", 82, 0, 10, 11, 103
"d:\毕业设计\项目\后端项目\onlinestudy\src\middleware\file.middleware.js", "JavaScript", 49, 0, 4, 14, 67
"d:\毕业设计\项目\后端项目\onlinestudy\src\middleware\user.middleware.js", "JavaScript", 42, 0, 38, 7, 87
"d:\毕业设计\项目\后端项目\onlinestudy\src\router\auth.router.js", "JavaScript", 9, 0, 1, 3, 13
"d:\毕业设计\项目\后端项目\onlinestudy\src\router\course.router.js", "JavaScript", 10, 0, 5, 2, 17
"d:\毕业设计\项目\后端项目\onlinestudy\src\router\file.router.js", "JavaScript", 9, 0, 3, 2, 14
"d:\毕业设计\项目\后端项目\onlinestudy\src\router\home.router.js", "JavaScript", 5, 0, 0, 2, 7
"d:\毕业设计\项目\后端项目\onlinestudy\src\router\index.js", "JavaScript", 10, 0, 0, 2, 12
"d:\毕业设计\项目\后端项目\onlinestudy\src\router\user.router.js", "JavaScript", 7, 0, 0, 3, 10
"d:\毕业设计\项目\后端项目\onlinestudy\src\service\auth.service.js", "JavaScript", 25, 0, 0, 4, 29
"d:\毕业设计\项目\后端项目\onlinestudy\src\service\course.service.js", "JavaScript", 64, 0, 1, 9, 74
"d:\毕业设计\项目\后端项目\onlinestudy\src\service\file.service.js", "JavaScript", 60, 0, 0, 6, 66
"d:\毕业设计\项目\后端项目\onlinestudy\src\service\user.service.js", "JavaScript", 81, 0, 9, 8, 98
"d:\毕业设计\项目\后端项目\onlinestudy\src\utils\password-handler.js", "JavaScript", 7, 0, 0, 2, 9
"Total", "-", 775, 2360, 100, 115, 3350